<!--2020-09-05 10:42:51-->
G|----------(7)--------(7)----(7)------(7)-------(7)--(5)------|  
D|------(7)--------(7)------(7)-----(7)-------(7)--------(5)---|  
A|--(7)--------(7)--------(7)----(7)-------(7)--------------(5)|  
E|0------------------------------------------------------------|  
  
G|----------(7)--------(7)----(7)------(7)------(5)-----(5)----|  
D|------(7)--------(7)------(7)-----(7)------(7)---(5)----(5)--|  
A|--(7)--------(7)--------(7)----(7)------(7)---------(5)---(5)|  
E|0------------------------------------------------------------|  
  
G|------------------4-7-9-9-14-14-14-14-12-11------------------|  
D|--------------4-7---------------------------12-12-12-12-11---|  
A|----------5-7----------------------------------------------12|  
E|0-0-0-5-7----------------------------------------------------|  
  
G|-----------------------------(7)--------(7)----(7)--------(7)|  
D|7-7-7-6------------------(7)--------(7)------(7)------(7)----|  
A|--------7-3-3-3-2----(7)--------(7)--------(7)----(7)--------|  
E|------------------3-0----------------------------------------|  
  
G|---------(7)--(5)-------------------(7)---------(7)-----(7)--|  
D|-----(7)----------(5)-----------(7)---------(7)-------(7)----|  
A|-(7)------------------(5)---(7)---------(7)---------(7)------|  
E|--------------------------0----------------------------------|  
  
    *  
G|---------(7)--------(5)-------(5)-----9---5---7---4---5------|  
D|-----(7)--------(7)--------(5)-------9---5---7---4---5-------|  
A|-(7)---------(7)--------(5)---------7---3---5---2---3--------|  
E|-------------------------------------------------------------|  
  
(*) In this part, you must move your hand from fret to fret as  
fast as you can (and faster!). So, the notes played on the G  
string will sound sliding to the next.  
Pay a little attention to the disc to notice how it works.  
  
G|--9---5---7---4--------------(7)------(7)-----(7)---------(7)|  
D|-9---5---7---4---5--------(7)------(7)------(7)-------(7)----|  
A|7---3---5---2---3--0---(7)------(7)-------(7)-----(7)--------|  
E|---------------------0---------------------------------------|  
  
G|------(7)-(5)-----------------(7)------(7)----(7)---------(7)|  
D|---(7)-------(5)----------(7)-------(7)-----(7)-------(7)----|  
A|(7)-------------(5)---(7)--------(7)------(7)-----(7)--------|  
E|--------------------0----------------------------------------|  
  
G|---------(5)-(5)---------------------------------------------|  
D|-----(7)--------(5)--------------------5-4------------7-6----|  
A|-(7)---------------(5)----3-2----5-4--------5---7-6-------7--|  
E|------------------------------3------5--------------7--------|  
  
G|------------------------------------------  
D|-5-4---10-9----7-6---12-11----14-13-------  
A|-----5------10-----7-------12-------142--- <<====Here, you  
E|----------------------------------------0-   must slide from  
14 to 2 to make a "fall" sound. Once again,listen to the record  
to get the hang of it.  
  
G|------(7)---------(7)-----(7)--------(7)-------(7)--(5)------|  
D|---(7)--------(7)-------(7)-------(7)-------(7)--------(5)---|  
A|(7)-------(7)---------(7)------(7)-------(7)--------------(5)|  
E|-------------------------------------------------------------|  
  
G|----------(7)--------(7)---(7)-------(7)------(5)-----(5)----|  
D|------(7)--------(7)------(7)-----(7)------(7)---(5)----(5)--|  
A|--(7)--------(7)---------(7)---(7)------(7)---------(5)---(5)|  
E|0------------------------------------------------------------|  
  
G|-------9-----5-----7-----4-----5-|  
D|-----9-----5-----7-----4-----5---|  
A|---7-----3-----5-----2-----3-----|  
E|---------------------------------|  
  
G|-------9-----5-----7-----4-----5-|  
D|-----9-----5-----7-----4-----5---|  
A|---7-----3-----5-----2-----3-----|  
E|---------------------------------|