<!--2020-09-07 02:43:00-->
Spirits On The Material World  
  
  *Original music by Sting*  
  *h = hammer on for next note*  
  *p = pull off for next note*  
  *s = slide up to next note*  
  
  *Opening Riff*  
  |---------------------------------------------------------------------------  
  |---------------------------------------------------------------------------  
  |-------3---3---3---3-------------------------------------------------------  
  |---5-------------------5---3---3---3---5---0---3---------------------------  
  
  *Verse (repeat)*  
  |---------------------------------------------------------------------------  
  |---------------------------------------------------------------------------  
  |-------3---3---3---3-------------------------------------------------------  
  |---5-------------------5---3---3---3---5---0---3---------------------------  
   There is no political solution...  
  
  *Chorus*  
  |---------------------------------------------------------------------------  
  |-----------------------2---3---5-------------------------------------------  
  |---5---3---5---3---5---------------3---5-----------------------------------  
  |---------------------------------------------------------------------------  
   We are spirits in the material world  
  
  *Bridge into verse*  
  |---------------------------------------------------------------------------  
  |---2---3---5--s7---5---3---2---0-------------------------------------------  
  |-----------------------------------3---2-----------------------------------  
  |---------------------------------------------------------------------------