<!--2020-09-05 00:45:06-->
this song is pretty nasty sounding if you can have a second
guitar or Piano play the chords while you rock out on the power
chords at the bottom, works good in 4/4 with a snare hit on
every quarter or eight note, (pick your poison)enjoy!

     F5           Am5      Bb5        Am5
e-|------------------|------------------------|
B-|------------------|------------------------|
G-|--------2--3--5---|---7---7-7-7-5----------|
D-|--3--5--0--1--3---|---5---5-5-5-3----------|
A-|--1--3------------|------------------------|
E-|------------------|------------------------|
  I see trees of green   Red roses too
      Gm7                F5       A7        Dm5
e-|------------------|------------------------|
B-|------------------|------------------------|
G-|------------------|------------------------|
D-|--3--3-----5--2---|----------------2-------|
A-|--1--1-----3--0-5-|-3-------5---5--0---3---|
E-|----------------3-|-1-------3---3------1---|
     I  see   them     bloom   For me and you

        Db5               Gm7/C  C7         F5
e-|-------------------|-----------------------|
B-|-------------------|-----------------------|
G-|-------------------|-------------2---------|
D-|--3--3-----3--3-3--|---2----3-5--0--5-/-7--|
A-|--1--1-----1--1-1--|---0----1-3-----3-/-5--|
E-|-------------------|-----------------------|
 And I  think to myself   What a wonderful world

     F5           Am5      Bb5        Am5
e-|------------------|------------------------|
B-|------------------|------------------------|
G-|--------2--3--5---|---7---7-7-7-5----------|
D-|--3--5--0--1--3---|---5---5-5-5-3----------|
A-|--1--3------------|------------------------|
E-|------------------|------------------------|
 I see skys  of blue   And clouds of white

    Gm7                F5       A7        Dm5
e-|------------------|------------------------|
B-|------------------|------------------------|
G-|------------------|------------------------|
D-|--3--3-----5--2---|----------------2-------|
A-|--1--1-----3--0-5-|-3-------5---5--0---3---|
E-|----------------3-|-1-------3---3------1---|
    The bright blessed day The dark sacred night

        Db5               Gm7/C  C7         F5
e-|-------------------|-----------------------|
B-|-------------------|-----------------------|
G-|-------------------|-------------2---------|
D-|--3--3-----3--3-3--|---2----3-5--0--5-/-7--|
A-|--1--1-----1--1-1--|---0----1-3-----3-/-5--|
E-|-------------------|-----------------------|
 And I  think to myself   What a wonderful world

         C7
e-|-------------------|-----------------------|
B-|-------------------|-----------------------|
G-|-------------------|-----------------------|
D-|--5---5-5----5-----|--5---5---5------------|
A-|--3---3-3----3-----|--3---3---3------------|
E-|-------------------|-----------------------|
     The colors of       the rainbow

        F5
e-|-------------------|-----------------------|
B-|-------------------|-----------------------|
G-|-------------------|-----------------------|
D-|--7--7--7----------|--7---7--7-------------|
A-|--5--5--5----------|--5---5--5-------------|
E-|-------------------|-----------------------|
     So pretty           in the sky
         C7
e-|-------------------|-----------------------|
B-|-------------------|-----------------------|
G-|-------------------|-----------------------|
D-|--5---5-5----5-----|--5---5---5------------|
A-|--3---3-3----3-----|--3---3---3------------|
E-|-------------------|-----------------------|
     Are also   on       the faces

           F5
e-|-------------------|-----------------------|
B-|-------------------|-----------------------|
G-|-------------------|-----------------------|
D-|--7--7--7----------|--7---7--7-------------|
A-|--5--5--5----------|--5---5--5-------------|
E-|-------------------|-----------------------|

     Of people           going  by

          Dm5                 C5
e-|-------------------|-----------------------|
B-|-------------------|-----------------------|
G-|---5---7-------7---|--7---5----------------|
D-|-7-3---5-------5---|--5---3----------------|
A-|-5-----------------|-----------------------|
E-|-------------------|-----------------------|
    I see friends shak - ing hands
                  Dm5            C5
e-|-------------------|-----------------------|
B-|-------------------|-----------------------|
G-|---5--7--------7---|--7--7---5-------------|
D-|---3--5--------5---|--5--5---3-------------|
A-|-------------------|-----------------------|
E-|-------------------|-----------------------|
      saying,    "How    do you do?"

               Dm5                 C5
e-|-------------------|-----------------------|
B-|-------------------|-----------------------|
G-|---5---7-------7---|--7---5----------------|
D-|-7-3---5-------5---|--5---3----------------|
A-|-5-----------------|-----------------------|
E-|-------------------|-----------------------|
          They're real - ly

             Dm5            C5
e-|-------------------|-----------------------|
B-|-------------------|-----------------------|
G-|---5--7--------7---|--7--7---5-------------|
D-|---3--5--------5---|--5--5---3-------------|
A-|-------------------|-----------------------|
E-|-------------------|-----------------------|
              saying,    "I      love  you."