<!--2020-09-05 02:29:57-->
Tuning : B E A D G Time Signature: 4/4

tempo 98
|--------------------------------|--------------------------------|
|--------------------------------|--------------------------------|
|5-------------------------------|3-------------------------------|
|--------------------------------|--------------------------------|
|--------------------------------|--------------------------------|

|--------------------------------|--------------------------------|
|--------------------------------|--------------------------------|
|--------------------------------|1---------------3---------------|
|3-------------------------------|--------------------------------|
|--------------------------------|--------------------------------|

|--------------------------------|--------------------------------|
|--------------------------------|--------------------------------|
|5-------------------------------|--------------------------------|
|--------------------------------|--------------------------------|
|--------------------------------|3-------------------------------|

|--------------------------------|------------9-109---------------|
|--------------------------------|--------------------10----------|
|--------------------------------|------------------------10p-8---|
|--------------------------------|6-------------------------------|
|--------------------------------|--------------------------------|

|--------------------------------|------------------------12------|
|--------------------------------|--------------------------------|
|--------------------------------|--------------------------------|
|10------------------------------|----------------------------10--|
|--------------------------------|--------------------------------|

|--------------------------------|--------------------------------|
|--------------------------------|--------------------------------|
|--------------------------------|--------------------------------|
|10------------------------------|------------------------8-------|
|--------------------------------|--------------------------------|

|--------------------------------|--------------------------------|
|--------------------------------|--------------------------------|
|--------------------------------|------------------------3-------|
|6-------------------------------|--------------------------------|
|--------------------------------|--------------------------------|

|--------------------------------|--------------------------------|
|--------------------------------|--------------------------------|
|------------------------0---1---|3-----------3---3-------3-3-----|
|1-----------1---1---------------|----------------------------0-2-|
|--------------------------------|--------------------------------|

|--------------------------------|--------------------------------|
|--------------------------------|--------------------------------|
|------------------------0-------|1---------------1-------3-------|
|3-----------3---3---------------|------------1-------------------|
|--------------------------------|--------------------------------|

|--------------------------------|--------------------------------|
|--------------------------------|--------------------------------|
|5-----------5---5---------------|3-----------3---3---------------|
|--------------------------------|--------------------------------|
|--------------------------------|--------------------------------|

|--------------------------------|--------------------------------|
|--------------------------------|--------------------------------|
|1-------------------------------|--------------------------------|
|--------------------------------|--------------------------------|
|--------------------------------|--------------------------------|

|--------------------------------|--------------------------------|
|--------------------------------|--------------------------------|
|5-----------5---5---------------|3-----------3---3---------------|
|--------------------------------|--------------------------------|
|--------------------------------|--------------------------------|

|--------------------------------|--------------------------------|
|--------------------------------|--------------------------------|
|----------------------------0---|1---------------1-------3-------|
|3-----------3---3---------------|------------1-------------------|
|--------------------------------|--------------------------------|

|--------------------------------|--------------------------------|
|--------------------------------|--------------------------------|
|5-----------5---5---------------|3-----------3---3---------------|
|----------------------------5-5-|--------------------------------|
|--------------------------------|--------------------------------|

|--------------------------------|--------------------------------|
|--------------------------------|--------------------------------|
|------------------------0---1---|1---------------------------1---|
|3-----------3---3---------------|--------------------------------|
|--------------------------------|--------------------------------|

|--------------------------------|--------------------------------|
|--------------------------------|--------------------------------|
|--------------------------------|--------------------------------|
|--------------------------------|--------------------------------|
|3-----------3---3-----------3-3-|3-----------3---3---------------|

|--------------------------------|--------------------------------|
|0-------------------------------|--------------------------------|
|--------------------------------|--------------------------------|
|--------------------------------|--------------------------------|
|--------------------------------|--------------------------------|

|--------------------------------|--------------------------------|
|--------------------------------|--------------------------------|
|1-------------------------------|--------------------------------|
|--------------------------------|--------------------------------|
|--------------------------------|--------------------------------|

|--------------------------------|--------------------------------|
|--------------------------------|--------------------------------|
|5-----------5---5---------------|5-----------5---5-------3-0-3---|
|--------------------------------|--------------------------------|
|--------------------------------|--------------------------------|

|--------------------------------|--------------------------------|
|--------------------------------|--------------------------------|
|5-----------5---5---------------|5-----------5---5-------3-------|
|--------------------------------|--------------------------------|
|--------------------------------|--------------------------------|

|--------------------------------|--------------------------------|
|--------------------------------|--------------------------------|
|1-----------1---1---------------|1-----------1---1-------3-------|
|--------------------------------|--------------------------------|
|--------------------------------|--------------------------------|

|--------------------------------|--------------------------------|
|--------------------------------|--------------------------------|
|5-----------5---5-----------5---|3-----------3---3---------------|
|------------------------------5-|--------------------------------|
|--------------------------------|--------------------------------|

|--------------------------------|--------------------------------|
|--------------------------------|--------------------------------|
|------------------------0---0---|1---------------1-------3-------|
|3-----------3---3---------------|------------1-------------------|
|--------------------------------|--------------------------------|

|--------------------------------|--------------------------------|
|--------------------------------|--------------------------------|
|5-----------5---5---------------|3-----------3---3---------------|
|--------------------------------|--------------------------------|
|--------------------------------|--------------------------------|

|--------------------------------|--------------------------------|
|--------------------------------|--------------------------------|
|----------------------------0---|1---------------1-------3-------|
|3-----------3---3-------3-3-----|------------1-------------------|
|--------------------------------|--------------------------------|

|--------------------------------|--------------------------------|
|--------------------------------|--------------------------------|
|5-----------5---5-------5-5---5-|3-----------3---3---------------|
|----------------------------5---|--------------------------------|
|--------------------------------|--------------------------------|

|--------------------------------|--------------------------------|
|--------------------------------|--------------------------------|
|------------------------0---1---|----------------------------1---|
|3-----------3---3---------------|--------------------------------|
|--------------------------------|--------------------------------|

|--------------------------------|--------------------------------|
|0-------------------------------|0-------------------------------|
|--------------------------------|--------------------------------|
|--------------------------------|--------------------------------|
|--------------------------------|--------------------------------|

|--------------------------------|--------------------------------|
|--------------------------------|--------------------------------|
|0-------------------------------|--------------------------------|
|----------------------------3---|1-------------------------------|
|--------------------------------|--------------------------------|

|--------------------------------|--------------------------------|
|--------------------------------|--------------------------------|
|--------------------------------|--------------------------------|
|3---------------------------1---|0-------------------------------|
|--------------------------------|--------------------------------|

|--------------------------------|--------------------------------|
|--------------------------------|--------------------------------|
|--------------------------------|--------------------------------|
|1-------------------------------|3-------------------------------|
|--------------------------------|--------------------------------|

|--------------------------------|--------------------------------|
|--------------------------------|--------------------------------|
|0-------------------------------|--------------------------------|
|--------------------------------|--------------------------------|
|--------------------------------|--------------------------------|

|--------------------------------|--------------------------------|
|--------------------------------|--------------------------------|
|5-----------5---5---------------|5-----------5---5---------------|
|--------------------------------|--------------------------------|
|--------------------------------|--------------------------------|

|--------------------------------|--------------------------------|
|--------------------------------|--------------------------------|
|5-----------5---5---------------|5---------------5-------3-------|
|--------------------------------|------------5-------------------|
|--------------------------------|--------------------------------|

|--------------------------------|--------------------------------|
|--------------------------------|--------------------------------|
|1-----------1---1---------------|1-----------1---1-------3-------|
|--------------------------------|--------------------------------|
|--------------------------------|--------------------------------|

|--------------------------------|--------------------------------|
|--------------------------------|--------------------------------|
|5-----------5---5---------------|5---5---5---5---5---3---0-------|
|--------------------------------|----------------------------3---|
|--------------------------------|--------------------------------|

|--------------------------------|--------------------------------|
|--------------------------------|----------------------------2-3-|
|------------------------0---1---|3-----------3---3---------------|
|1-----------1---1---------------|--------------------------------|
|--------------------------------|--------------------------------|

|--------------------------------|--------------------------------|
|--------------------------------|--------------------------------|
|------------------------0-------|1---------------1-------3-------|
|3-----------3---3---------------|------------1-------------------|
|--------------------------------|--------------------------------|

|----------------7---------------|--------------------------------|
|------------5h7-----7-------7---|--------------------------------|
|5-----------------------5-------|3-----------3---3---------------|
|--------------------------------|--------------------------------|
|--------------------------------|--------------------------------|

|--------------------------------|--------------------------------|
|--------------------------------|--------------------------------|
|1-------------------------------|----------------1---1---3-3-3---|
|--------------------------------|--------------------------------|
|--------------------------------|--------------------------------|

|--------------------------------|--------------------------------|
|--------------------------------|--------------------------------|
|5-----------5---5-----------5---|3-----------3---3---------------|
|------------------------------5-|--------------------------------|
|--------------------------------|--------------------------------|

|--------------------------------|--------------------------------|
|--------------------------------|--------------------------------|
|------------------------0---0---|1---------------1-------3-------|
|3-----------3---3---------------|------------1-------------------|
|--------------------------------|--------------------------------|

|--------------------------------|--------------------------------|
|--------------------------------|--------------------------------|
|5-----------5---5-------------5-|3-----------3---3---------------|
|----------------------------5---|--------------------------------|
|--------------------------------|--------------------------------|

|--------------------------------|--------------------------------|
|--------------------------------|--------------------------------|
|------------------------0---0---|1---------------1-------3-------|
|3-----------3---3---------------|------------1-------------------|
|--------------------------------|--------------------------------|

|--------------------------------|--------------------------------|
|--------------------------------|--------------------------------|
|5-----------5---5-------------5-|3-----------3---3---------------|
|----------------------------5---|--------------------------------|
|--------------------------------|--------------------------------|

|--------------------------------|--------------------------------|
|--------------------------------|--------------------------------|
|------------------------0---0---|1---------------1-------3-------|
|3-----------3---3---------------|------------1-------------------|
|--------------------------------|--------------------------------|

|--------------------------------|--------------------------------|
|--------------------------------|------------------------------0-|
|5-----------5---5---------------|3-----------3---3-----------3---|
|--------------------------------|--------------------------------|
|--------------------------------|--------------------------------|

|--------------------------------|--------------------------------|
|--------------------------------|--------------------------------|
|------------------------0---0---|1-----------------1-----3-------|
|3-----------3---3---------------|------------1-------------------|
|--------------------------------|--------------------------------|