<!--2020-09-06 09:32:39-->
		The World Is New

!		(Bass)

		|-----------------------------------------------------------------
		|-----------------------------------------------------------------
		|1-------1-------1-1----------------------------------------------
		|-------------------------333333---444444-------------------------

		|-------------------------------------------------------------------------
		|----------1-----------1-----------1----3---------------------1-----------
		|1-2-3------1-2-3------1-2-3-----------3---0----1-2-3-----333333---444444-
		|-------------------------------------------------------------------------

		|-----------------------------------------------------------------
		|1-1-1-1---3-3-3-3--3-1-------------------------------------------
		|-------------------------------3-2-0-----------------------------
		|-----------------------------------------------------------------

!		SOLO!

		|-----------------------------------------------------------------
		|3--1-----------------------1--3----------------------------------
		|-------3--2--1--0--2--3------------------------------------------
		|-----------------------------------------------------------------

!		I THINK IT IS RIGHT?